Name	Symbol	WURCS
O-methoxy	OMeOH	*OCO
O-ethyl	OEt	*OCC
O-aminoethyl	OEtN	*OCCN
O-hydroxyethyl	OEtOH	*OCCO
O-methoxyethyl	OEtOMe	*OCCOC
O-propyl	OPr	*OCCC
N-methyl	NMe	*NC
N-dimethyl	NMe2	*NC/2C
N-ethyl	NEt	*NCC
N-formyl	NFo	*NC=O
thio	SH	*S
S-methyl	SMe	*SC
S-ethyl	SEt	*SCC
C-sulfate	CS	*SO/3=O/3=O
O-(1R)-1-carboxyethyl	OREtA	*OC^RCO/4=O/3C
pyrophosphate	PP	*OPOPO/5O/5=O/3O/3=O
triphosphate	PPP	*OPOPOPO/7O/7=O/5O/5=O/3O/3=O
fluolo	F	*F
bromo	Br	*Br
iodo	I	*I
